111111111111111111
100000E00000100011
100000000000100001
100000000000100001
10000000V000100011
10VV000P0000100011
10VV00000000000011
1000000C0000100011
100000000000100001
111111111111111111