11111111111111111111111111111111111111111
100000E00000100010C0100011000000001000001
100000000000100000C0100011000100001000001
100000000000100000C0100000000100001000001
100000000000100010C0100011000000000000001
100000P00000100010C0100000000000000000001
100000000000000010C0100011000000001000001
100000000000100010C0100000000000001000001
10000000V000100000C0100011000100001000001
10001000V000100010C010001100010CC01000001
100010000000100010C0100011000111111000001
1000C0000000100010C0100011000000001000001
100010000000100010C0100000000000001000001
10001110V000100010C010001100000000C000001
100000000000100010C0100000000100001000001
10001110V00000000000000011000100001000001
1000CCC0000000000000000000000C000010C0001
100011100000V000000000001100010000C000001
1000CCC0000000000000000000000100001000001
10000000000000000000000011000C00001000001
10000000000000V00000000011000C00001000001
11111111111111111111111111111111111111111